1,1,79,79
t,t,t,t,t,t,t,t,t,t,t,t,t,t,t,t,t,t,t,t,t,t,t,t,t,t,t,t,t,t,t,t,t,t,t,t,t,t,t,t,t,t,t,t,t,t,t,t,t,t,t,t,t,t,t,t,t,t,t,t,t,t,t,t,t,t,t,t,t,t,t,t,t,t,t,t,t,t,t,t
t,t,t,t,t,t,t,t,t,t,t,t,t,t,t,t,t,t,t,t,t,t,t,t,t,t,t,t,t,t,t,t,t,t,t,t,t,t,t,t,t,t,t,t,t,t,t,t,t,t,t,t,t,t,t,t,t,t,t,t,t,t,t,t,t,t,t,t,t,t,t,t,t,t,t,t,t,t,t,t
t,t,t,t,t,t,t,t,t,t,t,t,t,t,t,t,t,t,t,t,t,t,t,t,t,t,t,t,t,t,t,t,t,t,t,t,t,t,t,t,t,t,t,t,t,t,t,t,t,t,t,t,t,t,t,t,t,t,t,t,t,t,t,t,t,t,t,t,t,t,t,t,t,t,t,t,t,t,t,t,t,t,t,t,t,t,t,t,t,t,t,t,t,t,t,t,t,t,t,t,t,t,t,t,t,t,t,t,t,t,t,t,t,t,t,t,t,t,t,t,t,t,t,t,t,t,t,t,t,t,t,t,t,t,t,t,t,t,t,t,t,t,t,t,t,t,t,t,t
t,t,t,t,t,t,t,t,t,t,t,t,t,t,t,t,t,t,t,t,t,t,t,t,t,t,t,t,t,t,t,t,t,t,t,t,t,t,t,t,t,t,t,t,t,t,t,t,t,t,t,t,t,t,t,t,t,t,t,t,t,t,t,t,t,t,t,t,t,t,t,t,t,t,t,t,t,t,t,t
t,t,t,t,t,t,t,t,t,t,t,t,t,t,t,t,t,t,t,t,t,t,t,t,t,t,t,t,t,t,t,t,t,t,t,t,t,t,t,t,t,t,t,t,t,t,t,t,t,t,t,t,t,t,t,t,t,t,t,t,t,t,t,t,t,t,t,t,t,t,t,t,t,t,t,t,t,t,t,t
t,t,t,t,t,t,t,t,t,t,t,t,t,t,t,t,t,t,t,t,t,t,t,t,t,t,t,t,t,t,t,t,t,t,t,t,t,t,t,t,t,t,t,t,t,t,t,t,t,t,t,t,t,t,t,t,t,t,t,t,t,t,t,t,t,t,t,t,t,t,t,t,t,t,t,t,t,t,t,t
t,t,t,t,t,t,t,t,t,t,t,t,t,t,t,t,t,t,t,t,t,t,t,t,t,t,t,t,t,t,t,t,t,t,t,t,t,t,t,t,t,t,t,t,t,t,t,t,t,t,t,t,t,t,t,t,t,t,t,t,t,t,t,t,t,t,t,t,t,t,t,t,t,t,t,t,t,t,t,t
t,t,t,t,t,t,t,t,t,t,t,t,t,t,t,t,t,t,t,t,t,t,t,t,t,t,t,t,t,t,t,t,t,t,t,t,t,t,t,t,t,t,t,t,t,t,t,t,t,t,t,t,t,t,t,t,t,t,t,t,t,t,t,t,t,t,t,t,t,t,t,t,t,t,t,t,t,t,t,t
t,t,t,t,t,t,t,t,t,t,t,t,t,t,t,t,t,t,t,t,t,t,t,t,t,t,t,t,t,t,t,t,t,t,t,t,t,t,t,t,t,t,t,t,t,t,t,t,t,t,t,t,t,t,t,t,t,t,t,t,t,t,t,t,t,t,t,t,t,t,t,t,t,t,t,t,t,t,t,t
t,t,t,t,t,t,t,t,t,t,t,t,t,t,t,t,t,t,t,t,t,t,t,t,t,t,t,t,t,t,t,t,t,t,t,t,t,t,t,t,t,t,t,t,t,t,t,t,t,t,t,t,t,t,t,t,t,t,t,t,t,t,t,t,t,t,t,t,t,t,t,t,t,t,t,t,t,t,t,t
t,t,t,t,t,t,t,t,t,t,t,t,t,t,t,t,t,t,t,t,t,t,t,t,t,t,t,t,t,t,t,t,t,t,t,t,t,t,t,t,t,t,t,t,t,t,t,t,t,t,t,t,t,t,t,t,t,t,t,t,t,t,t,t,t,t,t,t,t,t,t,t,t,t,t,t,t,t,t,t
p,p,p,p,p,p,p,p,p,p,p,p,p,p,p,p,p,p,p,t,t,t,t,t,t,t,t,t,t,t,t,t,t,t,t,t,t,p,p,p,p,p,p,p,p,p,p,p,p,p,p,p,p,p,p,p,p,t,t,t,t,t,t,t,t,t,t,t,t,t,t,t,t,t,p,p,p,p,p,p
p,p,p,p,p,p,p,p,p,p,p,p,p,p,p,p,p,p,p,t,t,t,t,t,t,t,t,t,t,t,t,t,t,t,t,t,t,p,p,p,p,p,p,p,p,p,p,p,p,p,p,p,p,p,p,p,p,t,t,t,t,t,t,t,t,t,t,t,t,t,t,t,t,t,p,p,p,p,p,p
p,p,p,p,p,p,p,p,p,p,p,p,p,p,p,p,p,p,p,t,t,t,t,t,t,t,t,t,t,t,t,t,t,t,t,t,t,p,p,p,p,p,p,p,p,p,p,p,p,p,p,p,p,p,p,p,p,t,t,t,t,t,t,t,t,t,t,t,t,t,t,t,t,t,p,p,p,p,p,p
p,p,p,p,p,p,p,p,p,p,p,p,p,p,p,p,p,p,p,t,t,t,t,t,t,t,t,t,t,t,t,t,t,t,t,t,t,p,p,p,p,p,p,p,p,p,p,p,p,p,p,p,p,p,p,p,p,t,t,t,t,t,t,t,t,t,t,t,t,t,t,t,t,t,p,p,p,p,p,p
p,p,p,p,p,p,p,p,p,p,p,p,p,p,p,p,p,p,p,t,t,t,t,t,t,t,t,t,t,t,t,t,t,t,t,t,t,p,p,p,p,p,p,p,p,p,p,p,p,p,p,p,p,p,p,p,p,t,t,t,t,t,t,t,t,t,t,t,t,t,t,t,t,t,p,p,p,p,p,p
p,p,p,p,p,p,p,p,p,p,p,p,p,p,p,p,p,p,p,t,t,t,t,t,t,t,t,t,t,t,t,t,t,t,t,t,t,p,p,p,p,p,p,p,p,p,p,p,p,p,p,p,p,p,p,p,p,t,t,t,t,t,t,t,t,t,t,t,t,t,t,t,t,t,p,p,p,p,p,p
p,p,p,p,p,p,p,p,p,p,p,p,p,p,p,p,p,p,p,t,t,t,t,t,t,t,t,t,t,t,t,t,t,t,t,t,t,p,p,p,p,p,p,p,p,p,p,p,p,p,p,p,p,p,p,p,p,t,t,t,t,t,t,t,t,t,t,t,t,t,t,t,t,t,p,p,p,p,p,p
p,p,p,p,p,p,p,p,p,p,p,p,p,p,p,p,p,p,p,t,t,t,t,t,t,t,t,t,t,t,t,t,t,t,t,t,t,p,p,p,p,p,p,p,p,p,p,p,p,p,p,p,p,p,p,p,p,t,t,t,t,t,t,t,t,t,t,t,t,t,t,t,t,t,p,p,p,p,p,p
p,p,p,p,p,p,p,p,p,p,p,p,p,p,p,p,p,p,p,t,t,t,t,t,t,t,t,t,t,t,t,t,t,t,t,t,t,p,p,p,p,p,p,p,p,p,p,p,p,p,p,p,p,p,p,p,p,t,t,t,t,t,t,t,t,t,t,t,t,t,t,t,t,t,p,p,p,p,p,p
p,p,p,p,p,p,p,p,p,p,p,p,p,p,p,p,p,p,p,t,t,t,t,t,t,t,t,t,t,t,t,t,t,t,t,t,t,p,p,p,p,p,p,p,p,p,p,p,p,p,p,p,p,p,p,p,p,t,t,t,t,t,t,t,t,t,t,t,t,t,t,t,t,t,p,p,p,p,p,p
p,p,p,p,p,p,p,p,p,p,p,p,p,p,p,p,p,p,p,t,t,t,t,t,t,t,t,t,t,t,t,t,t,t,t,t,t,p,p,p,p,p,p,p,p,p,p,p,p,p,p,p,p,p,p,p,p,t,t,t,t,t,t,t,t,t,t,t,t,t,t,t,t,t,p,p,p,p,p,p
p,p,p,p,p,p,p,p,p,p,p,p,p,p,p,p,p,p,p,t,t,t,t,t,t,t,t,t,t,t,t,t,t,t,t,t,t,p,p,p,p,p,p,p,p,p,p,p,p,p,p,p,p,p,p,p,p,t,t,t,t,t,t,t,t,t,t,t,t,t,t,t,t,t,p,p,p,p,p,p
p,p,p,p,p,p,p,p,p,p,p,p,p,p,p,p,p,p,p,t,t,t,t,t,t,t,t,t,t,t,t,t,t,t,t,t,t,p,p,p,p,p,p,p,p,p,p,p,p,p,p,p,p,p,p,p,p,t,t,t,t,t,t,t,t,t,t,t,t,t,t,t,t,t,p,p,p,p,p,p
p,p,p,p,p,p,p,p,p,p,p,p,p,p,p,p,p,p,p,t,t,t,t,t,t,t,t,t,t,t,t,t,t,t,t,t,t,p,p,p,p,p,p,p,p,p,p,p,p,p,p,p,p,p,p,p,p,t,t,t,t,t,t,t,t,t,t,t,t,t,t,t,t,t,p,p,p,p,p,p
p,p,p,p,p,p,p,p,p,p,p,p,p,p,p,p,p,p,p,t,t,t,t,t,t,t,t,t,t,t,t,t,t,t,t,t,t,p,p,p,p,p,p,p,p,p,p,p,p,p,p,p,p,p,p,p,p,t,t,t,t,t,t,t,t,t,t,t,t,t,t,t,t,t,p,p,p,p,p,p
p,p,p,p,p,p,p,p,p,p,p,p,p,p,p,p,p,p,p,t,t,t,t,t,t,t,t,t,t,t,t,t,t,t,t,t,t,p,p,p,p,p,p,p,p,p,p,p,p,p,p,p,p,p,p,p,p,t,t,t,t,t,t,t,t,t,t,t,t,t,t,t,t,t,p,p,p,p,p,p
p,p,p,p,p,p,p,p,p,p,p,p,p,p,p,p,p,p,p,t,t,t,t,t,t,t,t,t,t,t,t,t,t,t,t,t,t,t,t,t,t,t,t,t,t,t,t,t,t,t,t,t,t,t,t,t,t,t,t,t,t,t,t,t,t,t,t,t,t,t,t,t,t,t,t,t,t,t,t,t
t,t,t,t,t,t,t,t,t,t,t,t,t,t,t,t,t,t,t,t,t,t,t,t,t,t,t,t,t,t,t,t,t,t,t,t,t,t,t,t,t,t,t,t,t,t,t,t,t,t,t,t,t,t,t,t,t,t,t,t,t,t,t,t,t,t,t,t,t,t,t,t,t,t,t,t,t,t,t,t
t,t,t,t,t,t,t,t,t,t,t,t,t,t,t,t,t,t,t,t,t,t,t,t,t,t,t,t,t,t,t,t,t,t,t,t,t,t,t,t,t,t,t,t,t,t,t,t,t,t,t,t,t,t,t,t,t,t,t,t,t,t,t,t,t,t,t,t,t,t,t,t,t,t,t,t,t,t,t,t
t,t,t,t,t,t,t,t,t,t,t,t,t,t,t,t,t,t,t,t,t,t,t,t,t,t,t,t,t,t,t,t,t,t,t,t,t,t,t,t,t,t,t,t,t,t,t,t,t,t,t,t,t,t,t,t,t,t,t,t,t,t,t,t,t,t,t,t,t,t,t,t,t,t,t,t,t,t,t,t
t,t,t,t,t,t,t,t,t,t,t,t,t,t,t,t,t,t,t,t,t,t,t,t,t,t,t,t,t,t,t,t,t,t,t,t,t,t,t,t,t,t,t,t,t,t,t,t,t,t,t,t,t,t,t,t,t,t,t,t,t,t,t,t,t,t,t,t,t,t,t,t,t,t,t,t,t,t,t,t
t,t,t,t,t,t,t,t,t,t,t,t,t,t,t,t,t,t,t,t,t,t,t,t,t,t,t,t,t,t,t,t,t,t,t,t,t,t,t,t,t,t,t,t,t,t,t,t,t,t,t,t,t,t,t,t,t,t,t,t,t,t,t,t,t,t,t,t,t,t,t,t,t,t,t,t,t,t,t,t
t,t,t,t,t,t,t,t,t,t,t,t,t,t,t,t,t,t,t,t,t,t,t,t,t,t,t,t,t,t,t,t,t,t,t,t,t,t,t,t,t,t,t,t,t,t,t,t,t,t,t,t,t,t,t,t,t,t,t,t,t,t,t,t,t,t,t,t,t,t,t,t,t,t,t,t,t,t,t,t
t,t,t,t,t,t,t,t,t,t,t,t,t,t,t,t,t,t,t,t,t,t,t,t,t,t,t,t,t,t,t,t,t,t,t,t,t,t,t,t,t,t,t,t,t,t,t,t,t,t,t,t,t,t,t,t,t,t,t,t,t,t,t,t,t,t,t,t,t,t,t,t,t,t,t,t,t,t,t,t
t,t,t,t,t,t,t,t,t,t,t,t,t,t,t,t,t,t,t,t,t,t,t,t,t,t,t,t,t,t,t,t,t,t,t,t,t,t,t,t,t,t,t,t,t,t,t,t,t,t,t,t,t,t,t,t,t,t,t,t,t,t,t,t,t,t,t,t,t,t,t,t,t,t,t,t,t,t,t,t
t,t,t,t,t,t,t,t,t,t,t,t,t,t,t,t,t,t,t,t,t,t,t,t,t,t,t,t,t,t,t,t,t,t,t,t,t,t,t,t,t,t,t,t,t,t,t,t,t,t,t,t,t,t,t,t,t,t,t,t,t,t,t,t,t,t,t,t,t,t,t,t,t,t,t,t,t,t,t,t
t,t,t,t,t,t,t,t,t,t,t,t,t,t,t,t,t,t,t,t,t,t,t,t,t,t,t,t,t,t,t,t,t,t,t,t,t,t,t,t,t,t,t,t,t,t,t,t,t,t,t,t,t,t,t,t,t,t,t,t,t,t,t,t,t,t,t,t,t,t,t,t,t,t,t,t,t,t,t,t
t,t,t,t,t,t,t,t,t,t,t,t,t,t,t,t,t,t,t,t,t,t,t,t,t,t,t,t,t,t,t,t,t,t,t,t,t,t,t,t,t,t,t,t,t,t,t,t,t,t,t,t,t,t,t,t,t,t,t,t,t,t,t,t,t,t,t,t,t,t,t,t,t,t,t,t,t,t,t,t
t,t,t,t,t,t,t,t,t,t,t,t,t,t,t,t,t,t,t,t,t,t,t,t,t,t,t,t,t,t,t,t,t,t,t,t,t,t,t,t,t,t,t,t,t,t,t,t,t,t,t,t,t,t,t,t,t,t,t,t,t,t,t,t,t,t,t,t,t,t,t,t,t,t,t,t,t,t,t,t
t,t,t,t,t,t,t,t,t,t,t,t,t,t,t,t,t,t,t,t,t,t,t,t,t,t,t,t,t,t,t,t,t,t,t,t,t,t,t,t,t,t,t,t,t,t,t,t,t,t,t,t,t,t,t,t,t,t,t,t,t,t,t,t,t,t,t,t,t,t,t,t,t,t,t,t,t,t,t,t
t,t,t,t,t,t,t,t,t,t,t,t,t,t,t,t,t,t,t,t,t,t,t,t,t,t,t,t,t,t,t,t,t,t,t,t,t,t,t,t,t,t,t,t,t,t,t,t,t,t,t,t,t,t,t,t,t,t,t,t,t,t,t,t,t,t,t,t,t,t,t,t,t,t,t,t,t,t,t,t
t,t,t,t,t,t,t,t,t,t,t,t,t,t,t,t,t,t,t,t,t,t,t,t,t,t,t,t,t,t,t,t,t,t,t,t,t,t,t,t,t,t,t,t,t,t,t,t,t,t,t,t,t,t,t,t,t,t,t,t,t,t,t,t,t,t,t,t,t,t,t,t,t,t,t,t,t,t,t,t
t,t,t,t,t,t,t,t,t,t,t,t,t,t,t,t,t,t,t,t,t,t,t,t,t,t,t,t,t,t,t,t,t,t,t,t,t,t,t,t,t,t,t,t,t,t,t,t,t,t,t,t,t,t,t,t,t,t,t,t,t,t,t,t,t,t,t,t,t,t,t,t,t,t,t,t,t,t,t,t
t,t,t,t,t,t,t,t,t,t,t,t,t,t,t,t,t,t,t,t,t,t,t,t,t,t,t,t,t,t,t,t,t,t,t,t,t,t,t,t,t,t,t,t,t,t,t,t,t,t,t,t,t,t,t,t,t,t,t,t,t,t,t,t,t,t,t,t,t,t,t,t,t,t,t,t,t,t,t,t
t,t,t,t,t,t,t,t,t,t,t,t,t,t,t,t,t,t,t,t,t,t,t,t,t,t,t,t,t,t,t,t,t,t,t,t,t,t,t,t,t,t,t,t,t,t,t,t,t,t,t,t,t,t,t,t,t,t,t,t,t,t,t,t,t,t,t,t,t,t,t,t,t,t,t,t,t,t,t,t
t,t,t,t,t,t,t,t,t,t,t,t,t,t,t,t,t,t,t,t,t,t,t,t,t,t,t,t,t,t,t,t,t,t,t,t,t,t,t,t,t,t,t,t,t,t,t,t,t,t,t,t,t,t,t,t,t,t,t,t,t,t,t,t,t,t,t,t,t,t,t,t,t,t,t,t,t,t,t,t
t,t,t,t,t,t,t,t,t,t,t,t,t,t,t,t,t,t,t,t,t,t,t,t,t,t,t,t,t,t,t,t,t,t,t,t,t,t,t,t,t,t,t,t,t,t,t,t,t,t,t,t,t,t,t,t,t,t,t,t,t,t,t,t,t,t,t,t,t,t,t,t,t,t,t,t,t,t,t,t
p,p,p,p,p,p,p,p,p,p,p,p,p,p,p,p,p,p,p,t,t,t,t,t,t,t,t,t,t,t,t,t,t,t,t,t,t,p,p,p,p,p,p,p,p,p,p,p,p,p,p,p,p,p,p,p,p,t,t,t,t,t,t,t,t,t,t,t,t,t,t,t,t,t,p,p,p,p,p,p
p,p,p,p,p,p,p,p,p,p,p,p,p,p,p,p,p,p,p,t,t,t,t,t,t,t,t,t,t,t,t,t,t,t,t,t,t,p,p,p,p,p,p,p,p,p,p,p,p,p,p,p,p,p,p,p,p,t,t,t,t,t,t,t,t,t,t,t,t,t,t,t,t,t,p,p,p,p,p,p
p,p,p,p,p,p,p,p,p,p,p,p,p,p,p,p,p,p,p,t,t,t,t,t,t,t,t,t,t,t,t,t,t,t,t,t,t,p,p,p,p,p,p,p,p,p,p,p,p,p,p,p,p,p,p,p,p,t,t,t,t,t,t,t,t,t,t,t,t,t,t,t,t,t,p,p,p,p,p,p
p,p,p,p,p,p,p,p,p,p,p,p,p,p,p,p,p,p,p,t,t,t,t,t,t,t,t,t,t,t,t,t,t,t,t,t,t,p,p,p,p,p,p,p,p,p,p,p,p,p,p,p,p,p,p,p,p,t,t,t,t,t,t,t,t,t,t,t,t,t,t,t,t,t,p,p,p,p,p,p
p,p,p,p,p,p,p,p,p,p,p,p,p,p,p,p,p,p,p,t,t,t,t,t,t,t,t,t,t,t,t,t,t,t,t,t,t,p,p,p,p,p,p,p,p,p,p,p,p,p,p,p,p,p,p,p,p,t,t,t,t,t,t,t,t,t,t,t,t,t,t,t,t,t,p,p,p,p,p,p
p,p,p,p,p,p,p,p,p,p,p,p,p,p,p,p,p,p,p,t,t,t,t,t,t,t,t,t,t,t,t,t,t,t,t,t,t,p,p,p,p,p,p,p,p,p,p,p,p,p,p,p,p,p,p,p,p,t,t,t,t,t,t,t,t,t,t,t,t,t,t,t,t,t,p,p,p,p,p,p
p,p,p,p,p,p,p,p,p,p,p,p,p,p,p,p,p,p,p,t,t,t,t,t,t,t,t,t,t,t,t,t,t,t,t,t,t,p,p,p,p,p,p,p,p,p,p,p,p,p,p,p,p,p,p,p,p,t,t,t,t,t,t,t,t,t,t,t,t,t,t,t,t,t,p,p,p,p,p,p
p,p,p,p,p,p,p,p,p,p,p,p,p,p,p,p,p,p,p,t,t,t,t,t,t,t,t,t,t,t,t,t,t,t,t,t,t,p,p,p,p,p,p,p,p,p,p,p,p,p,p,p,p,p,p,p,p,t,t,t,t,t,t,t,t,t,t,t,t,t,t,t,t,t,p,p,p,p,p,p
p,p,p,p,p,p,p,p,p,p,p,p,p,p,p,p,p,p,p,t,t,t,t,t,t,t,t,t,t,t,t,t,t,t,t,t,t,p,p,p,p,p,p,p,p,p,p,p,p,p,p,p,p,p,p,p,p,t,t,t,t,t,t,t,t,t,t,t,t,t,t,t,t,t,p,p,p,p,p,p
p,p,p,p,p,p,p,p,p,p,p,p,p,p,p,p,p,p,p,t,t,t,t,t,t,t,t,t,t,t,t,t,t,t,t,t,t,p,p,p,p,p,p,p,p,p,p,p,p,p,p,p,p,p,p,p,p,t,t,t,t,t,t,t,t,t,t,t,t,t,t,t,t,t,p,p,p,p,p,p
p,p,p,p,p,p,p,p,p,p,p,p,p,p,p,p,p,p,p,t,t,t,t,t,t,t,t,t,t,t,t,t,t,t,t,t,t,p,p,p,p,p,p,p,p,p,p,p,p,p,p,p,p,p,p,p,p,t,t,t,t,t,t,t,t,t,t,t,t,t,t,t,t,t,p,p,p,p,p,p
p,p,p,p,p,p,p,p,p,p,p,p,p,p,p,p,p,p,p,t,t,t,t,t,t,t,t,t,t,t,t,t,t,t,t,t,t,p,p,p,p,p,p,p,p,p,p,p,p,p,p,p,p,p,p,p,p,t,t,t,t,t,t,t,t,t,t,t,t,t,t,t,t,t,p,p,p,p,p,p
p,p,p,p,p,p,p,p,p,p,p,p,p,p,p,p,p,p,p,t,t,t,t,t,t,t,t,t,t,t,t,t,t,t,t,t,t,p,p,p,p,p,p,p,p,p,p,p,p,p,p,p,p,p,p,p,p,t,t,t,t,t,t,t,t,t,t,t,t,t,t,t,t,t,p,p,p,p,p,p
p,p,p,p,p,p,p,p,p,p,p,p,p,p,p,p,p,p,p,t,t,t,t,t,t,t,t,t,t,t,t,t,t,t,t,t,t,p,p,p,p,p,p,p,p,p,p,p,p,p,p,p,p,p,p,p,p,t,t,t,t,t,t,t,t,t,t,t,t,t,t,t,t,t,p,p,p,p,p,p
p,p,p,p,p,p,p,p,p,p,p,p,p,p,p,p,p,p,p,t,t,t,t,t,t,t,t,t,t,t,t,t,t,t,t,t,t,p,p,p,p,p,p,p,p,p,p,p,p,p,p,p,p,p,p,p,p,t,t,t,t,t,t,t,t,t,t,t,t,t,t,t,t,t,p,p,p,p,p,p
p,p,p,p,p,p,p,p,p,p,p,p,p,p,p,p,p,p,p,t,t,t,t,t,t,t,t,t,t,t,t,t,t,t,t,t,t,p,p,p,p,p,p,p,p,p,p,p,p,p,p,p,p,p,p,p,p,t,t,t,t,t,t,t,t,t,t,t,t,t,t,t,t,t,p,p,p,p,p,p
t,t,t,t,t,t,t,t,t,t,t,t,t,t,t,t,t,t,t,t,t,t,t,t,t,t,t,t,t,t,t,t,t,t,t,t,t,t,t,t,t,t,t,t,t,t,t,t,t,t,t,t,t,t,t,t,t,t,t,t,t,t,t,t,t,t,t,t,t,t,t,t,t,t,t,t,t,t,t,t
t,t,t,t,t,t,t,t,t,t,t,t,t,t,t,t,t,t,t,t,t,t,t,t,t,t,t,t,t,t,t,t,t,t,t,t,t,t,t,t,t,t,t,t,t,t,t,t,t,t,t,t,t,t,t,t,t,t,t,t,t,t,t,t,t,t,t,t,t,t,t,t,t,t,t,t,t,t,t,t
t,t,t,t,t,t,t,t,t,t,t,t,t,t,t,t,t,t,t,t,t,t,t,t,t,t,t,t,t,t,t,t,t,t,t,t,t,t,t,t,t,t,t,t,t,t,t,t,t,t,t,t,t,t,t,t,t,t,t,t,t,t,t,t,t,t,t,t,t,t,t,t,t,t,t,t,t,t,t,t
t,t,t,t,t,t,t,t,t,t,t,t,t,t,t,t,t,t,t,t,t,t,t,t,t,t,t,t,t,t,t,t,t,t,t,t,t,t,t,t,t,t,t,t,t,t,t,t,t,t,t,t,t,t,t,t,t,t,t,t,t,t,t,t,t,t,t,t,t,t,t,t,t,t,t,t,t,t,t,t
t,t,t,t,t,t,t,t,t,t,t,t,t,t,t,t,t,t,t,t,t,t,t,t,t,t,t,t,t,t,t,t,t,t,t,t,t,t,t,t,t,t,t,t,t,t,t,t,t,t,t,t,t,t,t,t,t,t,t,t,t,t,t,t,t,t,t,t,t,t,t,t,t,t,t,t,t,t,t,t
t,t,t,t,t,t,t,t,t,t,t,t,t,t,t,t,t,t,t,t,t,t,t,t,t,t,t,t,t,t,t,t,t,t,t,t,t,t,t,t,t,t,t,t,t,t,t,t,t,t,t,t,t,t,t,t,t,t,t,t,t,t,t,t,t,t,t,t,t,t,t,t,t,t,t,t,t,t,t,t
t,t,t,t,t,t,t,t,t,t,t,t,t,t,t,t,t,t,t,t,t,t,t,t,t,t,t,t,t,t,t,t,t,t,t,t,t,t,t,t,t,t,t,t,t,t,t,t,t,t,t,t,t,t,t,t,t,t,t,t,t,t,t,t,t,t,t,t,t,t,t,t,t,t,t,t,t,t,t,t
t,t,t,t,t,t,t,t,t,t,t,t,t,t,t,t,t,t,t,t,t,t,t,t,t,t,t,t,t,t,t,t,t,t,t,t,t,t,t,t,t,t,t,t,t,t,t,t,t,t,t,t,t,t,t,t,t,t,t,t,t,t,t,t,t,t,t,t,t,t,t,t,t,t,t,t,t,t,t,t
t,t,t,t,t,t,t,t,t,t,t,t,t,t,t,t,t,t,t,t,t,t,t,t,t,t,t,t,t,t,t,t,t,t,t,t,t,t,t,t,t,t,t,t,t,t,t,t,t,t,t,t,t,t,t,t,t,t,t,t,t,t,t,t,t,t,t,t,t,t,t,t,t,t,t,t,t,t,t,t
p,p,p,p,p,p,p,p,p,p,p,p,p,p,p,p,p,p,p,p,p,p,p,p,p,p,p,p,p,p,p,p,p,p,p,p,p,p,p,p,p,p,p,p,p,p,p,p,p,p,p,p,p,p,p,p,p,t,t,t,t,t,t,t,t,t,t,t,t,t,t,t,t,t,t,t,t,t,t,t
p,p,p,p,p,p,p,p,p,p,p,p,p,p,p,p,p,p,p,p,p,p,p,p,p,p,p,p,p,p,p,p,p,p,p,p,p,p,p,p,p,p,p,p,p,p,p,p,p,p,p,p,p,p,p,p,p,t,t,t,t,t,t,t,t,t,t,t,t,t,t,t,t,t,t,t,t,t,t,t
p,p,p,p,p,p,p,p,p,p,p,p,p,p,p,p,p,p,p,p,p,p,p,p,p,p,p,p,p,p,p,p,p,p,p,p,p,p,p,p,p,p,p,p,p,p,p,p,p,p,p,p,p,p,p,p,p,t,t,t,t,t,t,t,t,t,t,t,t,t,t,t,t,t,t,t,t,t,t,t
p,p,p,p,p,p,p,p,p,p,p,p,p,p,p,p,p,p,p,p,p,p,p,p,p,p,p,p,p,p,p,p,p,p,p,p,p,p,p,p,p,p,p,p,p,p,p,p,p,p,p,p,p,p,p,p,p,t,t,t,t,t,t,t,t,t,t,t,t,t,t,t,t,t,t,t,t,t,t,t
p,p,p,p,p,p,p,p,p,p,p,p,p,p,p,p,p,p,p,p,p,p,p,p,p,p,p,p,p,p,p,p,p,p,p,p,p,p,p,p,p,p,p,p,p,p,p,p,p,p,p,p,p,p,p,p,p,t,t,t,t,t,t,t,t,t,t,t,t,t,t,t,t,t,t,t,t,t,t,t
p,p,p,p,p,p,p,p,p,p,p,p,p,p,p,p,p,p,p,p,p,p,p,p,p,p,p,p,p,p,p,p,p,p,p,p,p,p,p,p,p,p,p,p,p,p,p,p,p,p,p,p,p,p,p,p,p,t,t,t,t,t,t,t,t,t,t,t,t,t,t,t,t,t,t,t,t,t,t,t
p,p,p,p,p,p,p,p,p,p,p,p,p,p,p,p,p,p,p,p,p,p,p,p,p,p,p,p,p,p,p,p,p,p,p,p,p,p,p,p,p,p,p,p,p,p,p,p,p,p,p,p,p,p,p,p,p,t,t,t,t,t,t,t,t,t,t,t,t,t,t,t,t,t,t,t,t,t,t,t
p,p,p,p,p,p,p,p,p,p,p,p,p,p,p,p,p,p,p,p,p,p,p,p,p,p,p,p,p,p,p,p,p,p,p,p,p,p,p,p,p,p,p,p,p,p,p,p,p,p,p,p,p,p,p,p,p,t,t,t,t,t,t,t,t,t,t,t,t,t,t,t,t,t,t,t,t,t,t,t
p,p,p,p,p,p,p,p,p,p,p,p,p,p,p,p,p,p,p,p,p,p,p,p,p,p,p,p,p,p,p,p,p,p,p,p,p,p,p,p,p,p,p,p,p,p,p,p,p,p,p,p,p,p,p,p,p,t,t,t,t,t,t,t,t,t,t,t,t,t,t,t,t,t,t,t,t,t,t,t